1011111111101110111011111111111110111110111111111
1000101000101010100010000010000010001010001000001
1110101110111010111011101110111011101010111011101
0010100010000010001000101000101000101010100010001
1110101110111011101110101111101010101010101111111
1000001000101000101010100000101010101010101000000
1111111011101011101010101110101011101010101011111
0000000010100010001010101010101010001010101000001
1110111110111010101011101010101011101011101011101
1000100000001010101000001010001000101000001010101
1011101111111010111011111011111010111011101110101
1010001000000010100010000000000010000010100000101
1110101011111110101110111110111111101110101110101
1000101010000000001000100010000010101000101010101
1111101110111011111011111011111110111011111010101
0000100000101010000000001000000000001000000000101
1110101111101110111110111011111011101011111011101
0010100000100000001010100000001010101010001010001
1110111110111110111011101111111010111010101110111
1000000010100010100000001000001010000010100000001
1111101110111010111111101111101010101110111111111
1000101000100010100000100000100010101000100010001
1110101110101110111010111110111011101010101110101
0000100010101000001010000010001010001010101000101
1111101110101110101011111011101110111010101011101
1000001000001010101000100000100000100010101010101
1011101011101010101110111011101111101111101010111
1010101010100010100010001010001000000000001010000
1110111110111110111111111011111111111111111011111
