111110111110111111101110111011101110111111111011111111111
000010100010000010001010101010101010100010001010001000001
101110101111111011111011101110111010101110111011101110111
101000100000001000001000001000000010101000100000000010100
111011101110111111101011101011111010101110111011111010111
100010101010000000100010100010001010100010001010001010001
111010111011101110111110111010111110111011101110111110101
001010000000101010000000001010000000100000100000000000101
111010111011101011111110111011111111101110111111101111111
100010001010001000001000100000100000001010000000101000000
101111111011101011101110111110101111101010111011101111111
101000000010101000100010000010100010101010101010000000001
101110111010101111111011111010111110101011101010111110111
100000101000100010000010001010000000101000001010100010100
111111101111101010111110111011101110101111101110101110101
000000000000001010100000100000101010000000100000001000101
111111111111111010101110101110101011111110101111101111101
000010000000000010101000101010101000000010101000100010001
111110111111101110101111101011101011101010101010111011101
100010100000101000101000001000001010101010101010001000101
101110111110111011101011101110101110101110111111101110111
100000100000000010001010100010101000101000100000000010001
111111101111111011101110101110111011101110101110111010111
100000001000001000100000101000000010000010001010101010100
101111101110101110101110101111111010111011111011101110111
101000100010100010101010100000001010100000000000000000001
101010111010111010101010101111101010111111111111111110111
101010100010101010101000100000101010100000000000100010100
101110101110101110101111111111101110101111111011101110101
100000101000100000100010000000000000100000101010100000101
101111101010111110111010111111101111101111101010101111101
101000101010000010001010100000101000001000001010101000001
111010101011111111111010111010111011111011101010101011111
000010101010000000100000001010000000001010101010001000100
111011101010111110101111111011111110111010101011101110111
101010001000100010001000000000100010100010101000100010001
101111101111111011111111111111101111101110111110111111111
