1011111111
1010000001
1011111101
1010000101
1011110101
1000010101
1111010101
0001010101
1111010101
1001110101
1011110101
1010000001
1011111101
1010000101
1011110101
1000010101
1111010101
0001010101
1111010101
0001110101
