1111111011111111101111111111101
0000001010000000101000100000101
1011101110111011101011101111101
1010100000100010001010001000001
1010111111101110111010111111111
1010001000101000000010000000000
1010101110101111111011111011111
1010100010000000001010001010001
1011111011111111101011101111101
1000001000000010001010000000001
1111101111101110111010111111111
1000100000101000100000100000001
1110101110101111101111101111111
0010101010100000000010000000000
1010111010101111111011101111111
1010000010101000001000101000001
1010111010101110101110111011101
1010101010100010100010000010101
1010101010101110111010111010111
1010001010101000100010101010001
1111111011111011111111101110111
