1110111111111010111110101111111111111
0010000000101010101010101000000000101
1110111011101011101011101011111011101
1000101010001010001000001010100010001
1011101110101010101011111010101110111
1010000000101010101010000000101000000
1110111110111011101111111110101011111
0000001000100000000000000010101010001
1111101011101111111110111111101111101
0010101010001000000010100000000000101
1110111011101011111110101111111110101
1000000000101000001000001000000010101
1111111110101111101011111011111010101
1000000010100010101000100010101010001
1110111110111010101111101010101011101
0010100010001000100000001010100000101
1010101110101111101111111010111110101
1010101000100000001010001010001010101
1110101111101111101011101011101010101
1000100000100010100010100010001000101
1011101111101110111010111110111011101
1010001000001000001000000000101010001
1010111010111011101011111011101010111
1010001010101000101010001010000010100
1011101011101110111011101110111010111
0000101000000010100010101000101010001
1111101011111110111010101011101110111
1000001010000000001000101010000000101
1011101011111011111111101011101111101
1010001000001010000000000000101000101
1011111111111011101111101110101011101
1010000000000010001000101010101010000
1010111110111110111010111011101011111
1000100010100000100010000000000000001
1011101010101110111111101110111111101
1010001010001010000000101010100000101
1111111011111011111111111011101111111
