10111111111110101111111110111110111
10100000000010101010000010100000101
10111011111010111011101111101110101
10001000100010100000100000001010101
11111011101110101111101111111011101
00000010001000001010001000000010001
11111110111011111010111011111011101
10001000100000100000100010001000101
10101011101110111111101110101110101
10101010001010100000001000100010001
11101010111010101111101011111011101
00001010100010101000001000100000101
11101011101010111011111011101110101
10101000001010000010000010101010101
10101110111011111011101110101011101
10100010101000001010101000101000001
10111110101111111010101011101111101
10000010100000000000101000000000101
11101010101111111011101111111110101
00101010100010001010001000001000101
11101110111011101110111011101110111
10001000001000100000100000100010001
11101011101110101110101111101111101
10100010100010101000100010101010001
10111110111011101111101110101010111
10000000100000001000001000101000100
10111110101111111011101011101111101
10100000101000000010101010000000001
11101111101011111110111011101110111
00101000101010000010000000101010101
10101110101010111010111011101011101
10100010001010101010100010000000001
11101011111011101010111110111111111
10001000000000000010100000001000001
11111111111111111110111111111011111
