1011111111111110111011101110111011111011111111101011111111111111111110111
1000001000001010101010101010101010101010000000101010000000000000001010101
1011101111101010101010101011101110101110111111101010111111101110111010101
1010100000001010101010100000000000100000001000001010001000100010100010100
1110111110111011101110111111111110101111101111111011101110111110101110111
0000000010100000000000000000000010101000100000001000100010000010100010001
1110111110101111111111111011111110101011101111101010111010111010111011111
1010100000100000001000001010000000101010000010101010001010101010001010000
1010101111101111111010111010111110111011111010111111101010101110111010111
1010100010001000000010100010100010100000001000000000001010000010100000101
1010111110111011111110111010111011111110101111111110111011111010101111101
1000000000100000000010001010001000000010100000000010100010001010101000001
1111111111101111111011101011101011101011101111101110111010111010111111101
1010000000101000001010001000100010101000100010101000001000100010000000101
1011111110101011101011111110111110101111111010101111101110101010111010101
0000000010001000101000000000000000100000001010000000100010101010101010101
1111111110111111101110111011111110111110111011111110101110101110101011101
1000000000100000000010101010000010000010001000100010101000100010101000001
1011111111101111101110101110111011101011101011101010101011111010101111101
1010000000001000101010100000101010101000101010001010101000001000100000101
1111101111111010101010111110101110111110101110111010111011111011101110111
1000001000000010101010000010100000001000101000001010000010000010001000001
1011111011111110111010111010111011101011101011101110111111101110111011111
1010000010001000000010101010001010101010000010100010000000101000101010000
1011101010101011101110101110101110101010111110111011111111101110101110111
1000101010101010101000100000100000100010100000001000000000100010100000001
1110101010101110101110111110111110111110111110101110111011101010101110111
0000101010100000100010000010101000000000100010100010001010001010101010101
1111101111101110111111101110101111111110111010111010111010111010111011101
1000001000001010100000001000100000000010100010100010100010100010000000001
1110111011111010111110111010111111111011101110111110111111101110111110101
1010100010000010000000100010000000001000001000100000000010001000100010101
1010111011101011111110111010111111111011101010101111111010111011101111101
0010000000101000000010001010100000100010101010100010001010100010100000001
1110111110111011101011101011101110111110101011111110111010111010101111111
1000101000001010101010101000001010000000001000000000100000001010101000000
1111101111101110101010101111111011111111101110111010111111111010101110111
1000000010100000101010000000000000000000100010101010000000000010000010100
1011111010101111101011111110111111101110111010101111111110101110111010111
1000100010101000001000000010101000101010001010100000000010101010101010101
1111101110101110111111111010101110101011111010111110111011101011101110101
0000101000000010001000001010100010001000000010100010101000001000000000001
1111101111111111111011111011111011111111111110111011101111111111111111111
