10111111111111101111111011111111111110111
10100000000000101000001000100000000010101
11101110111011101011101110101111111011101
00001000101010001010100010100010000000001
11111111101110111110101110111011111111111
10000000000000100000101000001010000000000
11111011111110101110101011111011111111111
00001010100000101000101010000000000000001
10111010111110111011101110111111111110111
10100000000010100010000000100000001000100
10101111111011101110111110111011101111101
10100010001000101000100010001010000000001
10111110101110101011101010111011111110111
10000000100010001010001010100010100010001
11111111101110111010111010101110111010111
10000010001000100010001010100000001010101
11101110111011101011101010111111111011101
10101000100010001000101010000000000000001
10101110101110111110111011101011111111111
10100000101000101010001010101010000000000
10111011101011101011101010111010111111111
00001010001000101000101010000010100000000
11111010101110101010101011111110111111111
10000010101010001010101000000000100000001
11111010101011101011101011111010101011111
10001010101000101000001010001010101010000
10111010111011101110111011101010101011111
10100010100010000010100010101010101000001
10111110111011111010111010101011111011101
10000000000000001010001000101000000010101
11111111111111111011111111101111111110111
